HHHHHHHHHHHHHHHHHHHH
H  HHHHHHHHHHHHHH  H
H  TTTTTTTTTTTTTM  H
HHTCTTTTTTTTTTTDTTHH
HHTTCTTTTTTTTTDTTTHH
HHTTTCTTTTTTTDTTTTHH
HHTTTTCTTTTTDTTTTTHH
HHTTTTTCTTTDTTTTTTHH
HHTTTTTTC DTTTTTTTHH
HHTTTTTTTKTTTTTTTTHH
HHTTTTTTTFETTTTTTTHH
HHTTTTTTFTTETTTTTTHH
HHTTTTTFTTTTETTTTTHH
HHTTTTFTTTTTTETTTTHH
HHTTTFTTTTTTTTETTTHH
HHTTFTTTTTTTTTTETTHH
HHTFTTTTTTTTTTTTETHH
H  TTTTTTTTTTTTTT  H
H  HHHHHHHHHHHHHH  H
HHHHHHHHHHHHHHHHHHHH