    EHF             
   EHUHF            
  EHUUUHF           
 EHUUUUHHF          
 HUUUUHHHHF         
 HUUUHHHUUHF        
 HUUUMHUUUUU        
 HUUUUUUUUHC        
 DHUUUUUUHC         
  DHUUUUHC          
   DHHHHC           