 HH  HCTTTTTTDHH    
 HCUUUUDUUUUUUDH H  
  U HH  HHHHTEU1UUD 
  U2CD  HTDHTUEH TT 
H UF EUU    HUHH  T 
CUUC0CDCD0 DH1    T 
UCUTHTFEFDFEHH    T 
UUUTHTCDCE2HHU    E 
FUUFTMEFECEHUEH   H 
HFTTTTTTTEHHUHH   CD
HHUUUUUU3HHUEH   3UE
        U  FUTUTUTE5
 HF T TTUTD        U
 HH     FUE      H U
4UHHF           ECUE
 UUHH  T        HF 4
 HUUUUUUUUUUUUUUUUUU
  H    U            
       5            