HH  HHH             
HCUUUDH             
 U   U              
 U   UHHHH          
 U   UCUDH          
 U   UF3UH   HHF    
 U 4UEHFEH   DHHF   
HFUUU2HHHH 2UUDHHF  
HH  EHHHHHHHHFUDHHF 
   EHHHH5UUUDHFUDHHF
  EHHCDHHHHH34HFUDHH
  HHC1 DCDHHHHHHFUDH
  HC    0EHHCDHHH UH
  HF    EHHC 1DHH UH
  HHF  EHHHF0 EHH UH
  DHHFEHC5DH HHHCUEH
   DHHHH    M   U HH
        HF  EH      
        HH  HH  U   