EHHHF  EHHHF        
HHHHHHHHHHHH        
HHMUUUUUU0HH        
HHUHUHUU1UHH        
DHUUUUU2UUHC        
 HUHUU3UUUH         
 HUUU0UUHUH         
EHUU1UUUUUHF        
HHU2UUHUHUHH        
HH3UUUUUUUHH        
HHHHHHHHHHHH        
DHHHC  DHHHC        