   EHF     EHF      
 EHHGHHF EHHGHHF    
EHGNPOGHHHGUUTDHF   
HGUHMHU0H0UUUUUGH   
DHGUUUGHHHFUTGEHC   
 DHHGHHC DHHUHHC    
   DHC     DHC      