HHQQQQQQQQHH        
HUSSSSSSSSUH        
HTRRRRRRRRTH        
HTUUUUUUUUTH        
HTUUUUUUUUTH        
HMUUUUUUUUTH        
HTUUUUUUUUTH        
HTQQQQQQQQTH        
HUSSSSSSSSUH        
HHRRRRRRRRHH        