 HHCUUUDHHH         
 HCUUUUUDHH         
 UUUUHCUUDH         
 HFUUCUUUUD         
 HUUCUUUEUU         
 HUCUFUEHUU         
 HUUUUECUUU         
 HFUUEUUMUE         
 HHFUUUFUEH         
 HHHHHHHUHH         