EHHHHHHHHHHHF       
HHHHHHHTUUUTH       
HHUUUHHUU0UUH       
HHUUUHHUU UUH       
HCUUUDHUUUUUH       
H NPO HHHHH H       
H NPO HCUDH H       
H  T QQU0UH H       
H  FTSS UEH H       
H U  RR  HH H       
H      M TT H       
DHHHHHHHHHHHC       